
F                                                                                                  I
HF                                                                                                 I
AHF                     x             EBBF       I                 I             III               I
AAHF                          EBBBBBBBGAAD y  {                             III                    I
AAAHF           z            EGAAAAAAAAAAD               II           III             I          * I
AAAAHBBBBBBBBBBBBBBBBBBBBBBBBGAAAAAAAAAAAHBBBBBBBBBB   II  II    III                      I   I  III
